              M
 WWWWWWWWWWW WW
     W       WW
     W       WW
 WWWWWWWWWW    
 W        W  WW
       WWWW  WW
        W     W
 WWWWWWWW  W   
    W      WWWW
WWW WW         
H    W  W    WW
        W    WW
WWWWWWWWW WWWWW
WWWWWWWWWWWWWWW